SO texture/direction/south.xpm
EA texture/direction/east.xpm
WE texture/direction/west.xpm
NO texture/direction/north.xpm

C 153,204,255
F 164,169,20

101000001000000000001
101010101011111110001
100010100010000010001
111110101111101011101
100000101000101000001
111111111111111111111
101111101011101111111
101000001010100000101
101011111010111110101
101010001010100010101
101110101010101010101
100000101010001010001
111111101011111011101
100000101000100010001
101110101110101110111
101000100000100010101
101011111111111111111
100010001000000010001
1111111110111110111011
1N0000000001001000000
111111111111111111111
