NO texture/direction/north.xpm
SO texture/direction/south.xpm
WE texture/direction/west.xpm
EA texture/direction/east.xpm

F 80,80,80
C 180,180,220

111111111111
100000000001
100000000001
10000N0000001
100000000001
111111111111