NO texture/direction/north.xpm
SO texture/direction/south.xpm
WE texture/direction/west.xpm
EA texture/direction/east.xpm

F 50,50,50
C 120,160,200

111111111111111
100000000000001
101111111111101
101000000000101
101011111110101
101010000010101
1000100E0010001
101010000010101
101011111110101
101000000000101
101111111111101
100000000000001
111111111111111